###########
#         #
# +     - #
#         #
#         #
#         #
#         #
#         #
#         #
#    ?    #
###########